12 ,12 ,12 ,12 ,12 ,12 ,12 ,12 ,12 ,12 ,12 ,12 ,12 ,12 ,0  ,12 ,12 ,12 ,12 ,12 ,12 ,12 ,12 ,12 ,12 ,12 ,12 ,12 ,12 ,12 ,12 ,12 ,12 ,12 ,02 ,02 ,02 ,02 ,02 ,12 ,12 ,12 ,12 ,12 ,12 ,12 ,12 ,12 ,12 ,12 ,12 ,12 ,12 ,12 ,12 ,12 ,12 ,12 ,12 ,12 ,
12 ,12 ,12 ,12 ,12 ,12 ,12 ,12 ,12 ,12 ,12 ,12 ,12 ,12 ,0  ,12 ,12 ,12 ,12 ,12 ,12 ,12 ,12 ,12 ,12 ,12 ,12 ,12 ,12 ,12 ,12 ,12 ,12 ,12 ,02 ,02 ,02 ,02 ,02 ,12 ,12 ,12 ,12 ,12 ,12 ,12 ,12 ,12 ,12 ,12 ,12 ,12 ,12 ,12 ,12 ,12 ,12 ,12 ,12 ,12 ,
12 ,12 ,12 ,12 ,12 ,12 ,12 ,12 ,12 ,12 ,12 ,12 ,12 ,12 ,0  ,12 ,12 ,12 ,12 ,12 ,12 ,12 ,12 ,12 ,12 ,12 ,12 ,12 ,12 ,12 ,12 ,12 ,12 ,12 ,02 ,02 ,02 ,02 ,02 ,12 ,12 ,12 ,12 ,12 ,12 ,12 ,12 ,12 ,12 ,12 ,12 ,12 ,12 ,12 ,12 ,12 ,12 ,12 ,12 ,12 ,
12 ,12 ,12 ,12 ,12 ,12 ,12 ,12 ,12 ,12 ,12 ,12 ,12 ,12 ,0  ,12 ,12 ,12 ,12 ,12 ,12 ,12 ,12 ,12 ,12 ,12 ,12 ,12 ,12 ,12 ,12 ,12 ,12 ,12 ,02 ,02 ,02 ,02 ,02 ,12 ,12 ,12 ,12 ,12 ,12 ,12 ,12 ,12 ,12 ,12 ,12 ,12 ,12 ,12 ,12 ,12 ,12 ,12 ,12 ,12 ,
12 ,12 ,12 ,12 ,12 ,12 ,12 ,12 ,12 ,12 ,12 ,12 ,12 ,12 ,0  ,12 ,12 ,12 ,12 ,12 ,12 ,12 ,12 ,12 ,12 ,12 ,12 ,12 ,12 ,12 ,12 ,12 ,12 ,12 ,02 ,02 ,02 ,02 ,02 ,12 ,12 ,12 ,12 ,12 ,12 ,12 ,12 ,12 ,12 ,12 ,12 ,12 ,12 ,12 ,12 ,12 ,12 ,12 ,12 ,12 ,
12 ,12 ,12 ,12 ,12 ,12 ,12 ,12 ,12 ,12 ,12 ,12 ,12 ,1  ,0  ,1  ,12 ,12 ,1  ,12 ,1  ,1  ,1  ,12 ,1  ,1  ,1  ,1  ,1  ,1  ,1  ,1  ,1  ,1  ,0  ,0  ,0  ,0  ,0  ,1  ,1  ,1  ,1  ,1  ,1  ,1  ,1  ,1  ,1  ,1  ,1  ,1  ,1  ,1  ,1  ,12 ,12 ,12 ,12 ,12 ,
12 ,12 ,12 ,12 ,12 ,1  ,1  ,1  ,1  ,1  ,12 ,12 ,1  ,1  ,0  ,1  ,12 ,1  ,1  ,12 ,12 ,1  ,12 ,12 ,1  ,1  ,1  ,1  ,1  ,1  ,1  ,1  ,1  ,1  ,0  ,0  ,0  ,0  ,0  ,1  ,1  ,1  ,1  ,1  ,1  ,1  ,1  ,1  ,1  ,1  ,1  ,1  ,1  ,1  ,1  ,12 ,12 ,12 ,12 ,12 ,
12 ,12 ,12 ,12 ,1  ,1  ,1  ,1  ,1  ,1  ,1  ,1  ,1  ,0  ,0  ,0  ,1  ,12 ,12 ,1  ,1  ,12 ,1  ,1  ,12 ,1  ,1  ,1  ,1  ,1  ,1  ,1  ,1  ,1  ,0  ,0  ,0  ,0  ,0  ,1  ,1  ,1  ,1  ,1  ,1  ,1  ,1  ,1  ,1  ,1  ,1  ,1  ,1  ,1  ,1  ,12 ,12 ,12 ,12 ,12 ,
12 ,12 ,12 ,1  ,1  ,1  ,1  ,1  ,1  ,1  ,1  ,1  ,0  ,0  ,1  ,0  ,1  ,12 ,1  ,12 ,12 ,12 ,1  ,12 ,1  ,12 ,1  ,1 ,1  ,1  ,1  ,1  ,1  ,1  ,0  ,0  ,0  ,0  ,0  ,1  ,1  ,1  ,1  ,1  ,1  ,1  ,1  ,1  ,1  ,1  ,1  ,1  ,1  ,1  ,1  ,12 ,12 ,12 ,12 ,12 ,
12 ,12 ,12 ,1  ,1  ,0  ,0  ,0  ,0  ,0  ,0  ,0  ,0  ,1  ,1  ,0  ,0  ,156,1  ,1  ,1  ,1  ,12 ,1  ,1  ,1  ,12 ,1  ,1  ,1  ,1  ,1  ,1  ,1  ,0  ,0  ,0  ,0  ,0  ,1  ,1  ,1  ,1  ,1  ,1  ,1  ,1  ,1  ,1  ,1  ,1  ,1  ,1  ,1  ,1  ,12 ,12 ,12 ,12 ,12 ,
12 ,12 ,12 ,1  ,1  ,0  ,0  ,0  ,0  ,0  ,1  ,1  ,1  ,1  ,1  ,1  ,0  ,0  ,0  ,0  ,0  ,0  ,12 ,1  ,12 ,1  ,1  ,12 ,1  ,1  ,1  ,1  ,1  ,1  ,0  ,0  ,0  ,0  ,0  ,1  ,1  ,1  ,1  ,1  ,1  ,1  ,1  ,1  ,1  ,1  ,1  ,1  ,1  ,1  ,1  ,12 ,12 ,12 ,12 ,12 ,
12 ,12 ,12 ,1  ,1  ,0  ,0  ,0  ,0  ,0  ,1  ,12 ,1  ,1  ,1  ,1  ,1  ,1  ,1  ,0  ,0  ,0  ,1  ,1  ,12 ,12 ,1  ,12 ,1  ,1  ,1  ,1  ,1  ,1  ,0  ,0  ,0  ,0  ,0  ,1  ,1  ,1  ,1  ,1  ,1  ,1  ,1  ,1  ,1  ,1  ,1  ,1  ,1  ,1  ,1  ,12 ,12 ,12 ,12 ,12 ,
12 ,12 ,12 ,1  ,1  ,1  ,1  ,1  ,1  ,1  ,1  ,1  ,1  ,1  ,1  ,1  ,1  ,1  ,1  ,1  ,0  ,1  ,1  ,12 ,1  ,12 ,1  ,12 ,1  ,1  ,1  ,1  ,1  ,1  ,0  ,0  ,0  ,0  ,0  ,1  ,1  ,1  ,1  ,1  ,1  ,1  ,1  ,1  ,1  ,1  ,1  ,1  ,1  ,1  ,1  ,12 ,12 ,12 ,12 ,12 ,
12 ,12 ,12 ,1  ,1  ,1  ,1  ,1  ,1  ,1  ,1  ,1  ,1  ,1  ,1  ,1  ,1  ,1  ,1  ,1  ,0  ,1  ,1  ,1  ,1  ,1  ,12 ,12 ,1  ,1  ,1  ,1  ,1  ,1  ,0  ,0  ,0  ,0  ,0  ,1  ,1  ,1  ,1  ,1  ,1  ,1  ,1  ,1  ,1  ,1  ,1  ,1  ,1  ,1  ,1  ,12 ,12 ,12 ,12 ,12 ,
12 ,12 ,12 ,1  ,1  ,1  ,1  ,1  ,1  ,1  ,1  ,1  ,1  ,1  ,1  ,1  ,1  ,1  ,1  ,1  ,0  ,0  ,1  ,1  ,1  ,12 ,12 ,1  ,1  ,1  ,1  ,1  ,1  ,1  ,0  ,0  ,0  ,0  ,0  ,1  ,1  ,1  ,1  ,1  ,1  ,1  ,1  ,1  ,1  ,1  ,1  ,1  ,1  ,1  ,1  ,12 ,12 ,12 ,12 ,12 ,
12 ,12 ,12 ,1  ,1  ,1  ,1  ,1  ,1  ,1  ,1  ,1  ,1  ,1  ,1  ,1  ,1  ,1  ,1  ,1  ,1  ,0  ,0  ,1  ,1  ,1  ,1  ,1  ,1  ,1  ,1  ,1  ,1  ,1  ,0  ,0  ,0  ,0  ,0  ,1  ,1  ,1  ,1  ,1  ,1  ,1  ,1  ,1  ,1  ,1  ,1  ,1  ,1  ,1  ,1  ,12 ,12 ,12 ,12 ,12 ,
12 ,12 ,12 ,1  ,1  ,1  ,1  ,1  ,1  ,1  ,1  ,1  ,1  ,1  ,1  ,1  ,1  ,1  ,1  ,1  ,1  ,1  ,0  ,1  ,1  ,1  ,1  ,1  ,1  ,1  ,1  ,1  ,1  ,1  ,0  ,0  ,0  ,0  ,0  ,1  ,1  ,1  ,1  ,1  ,1  ,1  ,1  ,1  ,1  ,1  ,1  ,1  ,1  ,1  ,1  ,12 ,12 ,12 ,12 ,12 ,
12 ,12 ,12 ,1  ,1  ,1  ,1  ,1  ,1  ,1  ,1  ,1  ,1  ,1  ,1  ,1  ,1  ,1  ,1  ,1  ,1  ,1  ,1  ,1  ,1  ,1  ,1  ,1  ,1  ,1  ,1  ,1  ,1  ,1  ,0  ,0  ,0  ,0  ,0  ,1  ,1  ,1  ,1  ,1  ,1  ,1  ,1  ,1  ,1  ,1  ,1  ,1  ,1  ,1  ,1  ,12 ,12 ,12 ,12 ,12 ,
12 ,12 ,12 ,1  ,1  ,1  ,1  ,1  ,1  ,1  ,1  ,1  ,1  ,1  ,1  ,1  ,1  ,1  ,1  ,1  ,1  ,1  ,1  ,1  ,1  ,1  ,1  ,1  ,1  ,1  ,1  ,1  ,1  ,1  ,0  ,0  ,0  ,0  ,0  ,1  ,1  ,1  ,1  ,1  ,1  ,1  ,1  ,1  ,1  ,1  ,1  ,1  ,1  ,1  ,1  ,12 ,12 ,12 ,12 ,12 ,
12 ,12 ,12 ,1  ,1  ,1  ,1  ,1  ,1  ,1  ,1  ,1  ,1  ,1  ,1  ,1  ,1  ,1  ,1  ,1  ,1  ,1  ,1  ,1  ,1  ,1  ,1  ,1  ,1  ,1  ,1  ,1  ,1  ,1  ,0  ,0  ,0  ,0  ,0  ,1  ,1  ,1  ,1  ,1  ,1  ,1  ,1  ,1  ,1  ,1  ,1  ,1  ,1  ,1  ,1  ,12 ,12 ,12 ,12 ,12 ,
12 ,12 ,12 ,1  ,1  ,1  ,1  ,1  ,1  ,1  ,1  ,1  ,1  ,1  ,1  ,1  ,1  ,1  ,1  ,1  ,1  ,1  ,1  ,1  ,1  ,1  ,1  ,1  ,1  ,1  ,1  ,1  ,1  ,1  ,0  ,0  ,0  ,0  ,0  ,1  ,1  ,1  ,1  ,1  ,1  ,1  ,1  ,1  ,1  ,1  ,1  ,1  ,1  ,1  ,1  ,12 ,12 ,12 ,12 ,12 ,
12 ,12 ,12 ,1  ,1  ,1  ,1  ,1  ,1  ,1  ,1  ,1  ,1  ,1  ,1  ,1  ,1  ,1  ,1  ,1  ,1  ,1  ,1  ,1  ,1  ,1  ,1  ,1  ,1  ,1  ,1  ,1  ,1  ,1  ,0  ,0  ,0  ,0  ,0  ,1  ,1  ,1  ,1  ,1  ,1  ,1  ,1  ,1  ,1  ,1  ,1  ,1  ,1  ,1  ,1  ,12 ,12 ,12 ,12 ,12 ,
12 ,12 ,12 ,1  ,1  ,1  ,1  ,1  ,1  ,1  ,1  ,1  ,1  ,1  ,1  ,1  ,1  ,1  ,1  ,1  ,1  ,1  ,1  ,1  ,1  ,1  ,1  ,1  ,1  ,1  ,1  ,1  ,1  ,1  ,0  ,0  ,0  ,0  ,0  ,1  ,1  ,1  ,1  ,1  ,1  ,1  ,1  ,1  ,1  ,1  ,1  ,1  ,1  ,1  ,1  ,12 ,12 ,12 ,12 ,12 ,
12 ,12 ,12 ,1  ,1  ,1  ,1  ,1  ,1  ,1  ,1  ,1  ,1  ,1  ,1  ,1  ,1  ,1  ,1  ,1  ,1  ,1  ,1  ,1  ,1  ,1  ,1  ,1  ,1  ,1  ,1  ,1  ,1  ,1  ,0  ,0  ,0  ,0  ,0  ,1  ,1  ,1  ,1  ,1  ,1  ,1  ,1  ,1  ,1  ,1  ,1  ,1  ,1  ,1  ,1  ,12 ,12 ,12 ,12 ,12 ,
12 ,12 ,12 ,1  ,1  ,1  ,1  ,1  ,1  ,1  ,1  ,1  ,1  ,1  ,1  ,1  ,1  ,1  ,1  ,1  ,1  ,1  ,1  ,1  ,1  ,1  ,1  ,1  ,1  ,1  ,1  ,1  ,1  ,1  ,0  ,0  ,0  ,0  ,0  ,1  ,1  ,1  ,1  ,1  ,1  ,1  ,1  ,1  ,1  ,1  ,1  ,1  ,1  ,1  ,1  ,12 ,12 ,12 ,12 ,12 ,
12 ,12 ,12 ,1  ,1  ,1  ,1  ,1  ,1  ,1  ,1  ,1  ,1  ,1  ,1  ,1  ,1  ,1  ,1  ,1  ,1  ,1  ,1  ,1  ,1  ,1  ,1  ,1  ,1  ,1  ,1  ,1  ,1  ,1  ,0  ,0  ,0  ,0  ,0  ,1  ,1  ,1  ,1  ,1  ,1  ,1  ,1  ,1  ,1  ,1  ,1  ,1  ,1  ,1  ,1  ,12 ,12 ,12 ,12 ,12 ,
12 ,12 ,12 ,1  ,1  ,1  ,1  ,1  ,1  ,1  ,1  ,1  ,1  ,1  ,1  ,1  ,1  ,1  ,1  ,1  ,1  ,1  ,1  ,1  ,1  ,1  ,1  ,1  ,1  ,1  ,1  ,1  ,1  ,1  ,0  ,0  ,0  ,0  ,0  ,1  ,1  ,1  ,1  ,1  ,1  ,1  ,1  ,1  ,1  ,1  ,1  ,1  ,1  ,1  ,1  ,12 ,12 ,12 ,12 ,12 ,
12 ,12 ,12 ,1  ,1  ,1  ,1  ,1  ,1  ,1  ,1  ,1  ,1  ,1  ,1  ,1  ,1  ,1  ,1  ,1  ,1  ,1  ,1  ,1  ,1  ,1  ,1  ,1  ,1  ,1  ,1  ,1  ,1  ,1  ,0  ,0  ,0  ,0  ,0  ,1  ,1  ,1  ,1  ,1  ,1  ,1  ,1  ,1  ,1  ,1  ,1  ,1  ,1  ,1  ,1  ,12 ,12 ,12 ,12 ,12 ,
12 ,12 ,12 ,1  ,1  ,1  ,1  ,1  ,1  ,1  ,1  ,1  ,1  ,1  ,1  ,1  ,1  ,1  ,1  ,1  ,1  ,1  ,1  ,1  ,1  ,1  ,1  ,1  ,1  ,1  ,1  ,1  ,1  ,1  ,0  ,0  ,0  ,0  ,0  ,1  ,1  ,1  ,1  ,1  ,1  ,1  ,1  ,1  ,1  ,1  ,1  ,1  ,1  ,1  ,1  ,12 ,12 ,12 ,12 ,12 ,
12 ,12 ,12 ,1  ,1  ,1  ,1  ,1  ,1  ,1  ,1  ,1  ,1  ,1  ,1  ,1  ,1  ,1  ,1  ,1  ,1  ,1  ,1  ,1  ,1  ,1  ,1  ,1  ,1  ,1  ,1  ,1  ,1  ,1  ,0  ,0  ,0  ,0  ,0  ,1  ,1  ,1  ,1  ,1  ,1  ,1  ,1  ,1  ,1  ,1  ,1  ,1  ,1  ,1  ,1  ,12 ,12 ,12 ,12 ,12 ,
12 ,12 ,12 ,1  ,1  ,1  ,1  ,1  ,1  ,1  ,1  ,1  ,1  ,1  ,1  ,1  ,1  ,1  ,1  ,1  ,1  ,1  ,1  ,1  ,1  ,1  ,1  ,1  ,1  ,1  ,1  ,1  ,1  ,1  ,0  ,0  ,0  ,0  ,0  ,1  ,1  ,1  ,1  ,1  ,1  ,1  ,1  ,1  ,1  ,1  ,1  ,1  ,1  ,1  ,1  ,12 ,12 ,12 ,12 ,12 ,
12 ,12 ,12 ,1  ,1  ,1  ,1  ,1  ,1  ,1  ,1  ,1  ,1  ,1  ,1  ,1  ,1  ,1  ,1  ,1  ,1  ,1  ,1  ,1  ,1  ,1  ,1  ,1  ,1  ,1  ,1  ,1  ,1  ,1  ,0  ,0  ,0  ,0  ,0  ,1  ,1  ,1  ,1  ,1  ,1  ,1  ,1  ,1  ,1  ,1  ,1  ,1  ,1  ,1  ,1  ,12 ,12 ,12 ,12 ,12 ,
12 ,12 ,12 ,1  ,1  ,1  ,1  ,1  ,1  ,1  ,1  ,1  ,1  ,1  ,1  ,1  ,1  ,1  ,1  ,1  ,1  ,1  ,1  ,1  ,1  ,1  ,1  ,1  ,1  ,1  ,1  ,1  ,1  ,1  ,0  ,0  ,0  ,0  ,0  ,1  ,1  ,1  ,1  ,1  ,1  ,1  ,1  ,1  ,1  ,1  ,1  ,1  ,1  ,1  ,1  ,12 ,12 ,12 ,12 ,12 ,
12 ,12 ,12 ,1  ,1  ,1  ,1  ,1  ,1  ,1  ,1  ,1  ,1  ,1  ,1  ,1  ,1  ,1  ,1  ,1  ,1  ,1  ,1  ,1  ,1  ,1  ,1  ,1  ,1  ,1  ,1  ,1  ,1  ,1  ,0  ,0  ,0  ,0  ,0  ,1  ,1  ,1  ,1  ,1  ,1  ,1  ,1  ,1  ,1  ,1  ,1  ,1  ,1  ,1  ,1  ,12 ,12 ,12 ,12 ,12 ,
12 ,12 ,12 ,1  ,1  ,1  ,1  ,1  ,1  ,1  ,1  ,1  ,1  ,1  ,1  ,1  ,1  ,1  ,1  ,1  ,1  ,1  ,1  ,1  ,1  ,1  ,1  ,1  ,1  ,1  ,1  ,1  ,1  ,1  ,0  ,0  ,0  ,0  ,0  ,1  ,1  ,1  ,1  ,1  ,1  ,1  ,1  ,1  ,1  ,1  ,1  ,1  ,1  ,1  ,1  ,12 ,12 ,12 ,12 ,12 ,
12 ,12 ,12 ,1  ,1  ,1  ,1  ,1  ,1  ,1  ,1  ,1  ,1  ,1  ,1  ,1  ,1  ,1  ,1  ,1  ,1  ,1  ,1  ,1  ,1  ,1  ,1  ,1  ,1  ,1  ,1  ,1  ,1  ,1  ,0  ,0  ,0  ,0  ,0  ,1  ,1  ,1  ,1  ,1  ,1  ,1  ,1  ,1  ,1  ,1  ,1  ,1  ,1  ,1  ,1  ,12 ,12 ,12 ,12 ,12 ,
12 ,12 ,12 ,1  ,1  ,1  ,1  ,1  ,1  ,1  ,1  ,1  ,1  ,1  ,1  ,1  ,1  ,1  ,1  ,1  ,1  ,1  ,1  ,1  ,1  ,1  ,1  ,1  ,1  ,1  ,1  ,1  ,1  ,1  ,0  ,0  ,0  ,0  ,0  ,1  ,1  ,1  ,1  ,1  ,1  ,1  ,1  ,1  ,1  ,1  ,1  ,1  ,1  ,1  ,1  ,12 ,12 ,12 ,12 ,12 ,
34 ,34 ,34 ,34 ,34 ,34 ,34 ,34 ,34 ,34 ,34 ,34 ,34 ,34 ,34 ,34 ,34 ,34 ,34 ,34 ,34 ,34 ,34 ,34 ,34 ,34 ,34 ,34 ,34 ,34 ,34 ,34 ,34 ,34 ,34 ,34 ,34 ,34 ,34 ,34 ,34 ,34 ,34 ,34 ,34 ,34 ,34 ,34 ,34 ,34 ,34 ,34 ,34 ,34 ,34 ,34 ,34 ,34 ,34 ,34 ,
3  ,3  ,3  ,3  ,3  ,3  ,3  ,3  ,3  ,3  ,3  ,3  ,3  ,3  ,3  ,3  ,3  ,3  ,3  ,3  ,3  ,3  ,3  ,3  ,3  ,3  ,3  ,3  ,3  ,3  ,3  ,3  ,3  ,3  ,3  ,3  ,3  ,3  ,3  ,3  ,3  ,3  ,3  ,3  ,3  ,3  ,3  ,3  ,3  ,3  ,3  ,3  ,3  ,3  ,3  ,3  ,3  ,3  ,3  ,3  ,
3  ,3  ,3  ,3  ,3  ,3  ,3  ,3  ,3  ,3  ,3  ,3  ,3  ,3  ,3  ,3  ,3  ,3  ,3  ,3  ,3  ,3  ,3  ,3  ,3  ,3  ,3  ,3  ,3  ,3  ,3  ,3  ,3  ,3  ,3  ,3  ,3  ,3  ,3  ,3  ,3  ,3  ,3  ,3  ,3  ,3  ,3  ,3  ,3  ,3  ,3  ,3  ,3  ,3  ,3  ,3  ,3  ,3  ,3  ,3  ,
3  ,3  ,3  ,3  ,3  ,3  ,3  ,3  ,3  ,3  ,3  ,3  ,3  ,3  ,3  ,3  ,3  ,3  ,3  ,3  ,3  ,3  ,3  ,3  ,3  ,3  ,3  ,3  ,3  ,3  ,3  ,3  ,3  ,3  ,3  ,3  ,3  ,3  ,3  ,3  ,3  ,3  ,3  ,3  ,3  ,3  ,3  ,3  ,3  ,3  ,3  ,3  ,3  ,3  ,3  ,3  ,3  ,3  ,3  ,3  ,
3  ,3  ,3  ,3  ,3  ,3  ,3  ,3  ,3  ,3  ,3  ,3  ,3  ,3  ,3  ,3  ,3  ,3  ,3  ,3  ,3  ,3  ,3  ,3  ,3  ,3  ,3  ,3  ,3  ,3  ,3  ,3  ,3  ,3  ,3  ,3  ,3  ,3  ,3  ,3  ,3  ,3  ,3  ,3  ,3  ,3  ,3  ,3  ,3  ,3  ,3  ,3  ,3  ,3  ,3  ,3  ,3  ,3  ,3  ,3  ,
3  ,3  ,3  ,3  ,3  ,3  ,3  ,3  ,3  ,3  ,3  ,3  ,3  ,3  ,3  ,3  ,3  ,3  ,3  ,3  ,3  ,3  ,3  ,3  ,3  ,3  ,3  ,3  ,3  ,3  ,3  ,3  ,3  ,3  ,3  ,3  ,3  ,3  ,3  ,3  ,3  ,3  ,3  ,3  ,3  ,3  ,3  ,3  ,3  ,3  ,3  ,3  ,3  ,3  ,3  ,3  ,3  ,3  ,3  ,3  ,
3  ,3  ,3  ,3  ,3  ,3  ,3  ,3  ,3  ,3  ,3  ,3  ,3  ,3  ,3  ,3  ,3  ,3  ,3  ,3  ,3  ,3  ,3  ,3  ,3  ,3  ,3  ,3  ,3  ,3  ,3  ,3  ,3  ,3  ,3  ,3  ,3  ,3  ,3  ,3  ,3  ,3  ,3  ,3  ,3  ,3  ,3  ,3  ,3  ,3  ,3  ,3  ,3  ,3  ,3  ,3  ,3  ,3  ,3  ,3  ,
3  ,3  ,3  ,3  ,3  ,3  ,3  ,3  ,3  ,3  ,3  ,3  ,3  ,3  ,3  ,3  ,3  ,3  ,3  ,3  ,3  ,3  ,3  ,3  ,3  ,3  ,3  ,3  ,3  ,3  ,3  ,3  ,3  ,3  ,3  ,3  ,3  ,3  ,3  ,3  ,3  ,3  ,3  ,3  ,3  ,3  ,3  ,3  ,3  ,3  ,3  ,3  ,3  ,3  ,3  ,3  ,3  ,3  ,3  ,3  ,
3  ,3  ,3  ,3  ,3  ,3  ,3  ,3  ,3  ,3  ,3  ,3  ,3  ,3  ,3  ,3  ,3  ,3  ,3  ,3  ,3  ,3  ,3  ,3  ,3  ,3  ,3  ,3  ,3  ,3  ,3  ,3  ,3  ,3  ,3  ,3  ,3  ,3  ,3  ,3  ,3  ,3  ,3  ,3  ,3  ,3  ,3  ,3  ,3  ,3  ,3  ,3  ,3  ,3  ,3  ,3  ,3  ,3  ,3  ,3  ,
3  ,3  ,3  ,3  ,3  ,3  ,3  ,3  ,3  ,3  ,3  ,3  ,3  ,3  ,3  ,3  ,3  ,3  ,3  ,3  ,3  ,3  ,3  ,3  ,3  ,3  ,3  ,3  ,3  ,3  ,3  ,3  ,3  ,3  ,3  ,3  ,3  ,3  ,3  ,3  ,3  ,3  ,3  ,3  ,3  ,3  ,3  ,3  ,3  ,3  ,3  ,3  ,3  ,3  ,3  ,3  ,3  ,3  ,3  ,3  ,
3  ,3  ,3  ,3  ,3  ,3  ,3  ,3  ,3  ,3  ,3  ,3  ,3  ,3  ,3  ,3  ,3  ,3  ,3  ,3  ,3  ,3  ,3  ,3  ,3  ,3  ,3  ,3  ,3  ,3  ,3  ,3  ,3  ,3  ,3  ,3  ,3  ,3  ,3  ,3  ,3  ,3  ,3  ,3  ,3  ,3  ,3  ,3  ,3  ,3  ,3  ,3  ,3  ,3  ,3  ,3  ,3  ,3  ,3  ,3  *

0 - MUD
1 - GRASS
2 - TREE
3 - WATER_LAKE
4 - WATER_TOP