12 ,0  ,12 ,12 ,12 ,12 ,12 ,12 ,12 ,12 ,12 ,12 ,1  ,1  ,1  ,1  ,1  ,1  ,1  ,1  ,1  ,1  ,1  ,1  ,1  ,1  ,1  ,1  ,1  ,1  ,
12 ,0  ,12 ,12 ,12 ,12 ,12 ,12 ,12 ,12 ,12 ,12 ,1  ,1  ,1  ,1  ,1  ,1  ,1  ,1  ,1  ,1  ,1  ,1  ,1  ,1  ,1  ,1  ,1  ,1  ,
12 ,0  ,0  ,0  ,0  ,0  ,12 ,12 ,12 ,12 ,12 ,12 ,1  ,1  ,1  ,1  ,1  ,1  ,1  ,1  ,1  ,1  ,1  ,1  ,1  ,1  ,1  ,1  ,1  ,1  ,
12 ,0  ,12 ,12 ,12 ,0  ,12 ,12 ,12 ,12 ,12 ,12 ,1  ,1  ,1  ,1  ,1  ,1  ,1  ,1  ,1  ,1  ,1  ,1  ,1  ,1  ,1  ,1  ,1  ,1  ,
12 ,0  ,12 ,12 ,12 ,0  ,12 ,12 ,12 ,12 ,12 ,12 ,1  ,1  ,1  ,1  ,1  ,1  ,1  ,1  ,1  ,1  ,1  ,1  ,1  ,1  ,1  ,1  ,1  ,1  ,
12 ,0  ,12 ,12 ,12 ,0  ,12 ,12 ,12 ,12 ,12 ,12 ,1  ,1  ,1  ,1  ,1  ,1  ,1  ,1  ,1  ,1  ,1  ,1  ,1  ,1  ,1  ,1  ,1  ,1  ,
12 ,0  ,0  ,0  ,0  ,0  ,12 ,12 ,12 ,12 ,12 ,12 ,1  ,1  ,1  ,1  ,1  ,1  ,1  ,1  ,1  ,1  ,1  ,1  ,1  ,1  ,1  ,1  ,1  ,1  ,
12 ,0  ,1  ,1  ,1  ,0  ,12 ,12 ,12 ,12 ,12 ,12 ,1  ,1  ,1  ,1  ,0  ,1  ,1  ,1  ,1  ,1  ,1  ,1  ,1  ,1  ,1  ,1  ,1  ,1  ,
12 ,0  ,0  ,0  ,0  ,0  ,12 ,12 ,12 ,12 ,12 ,12 ,1  ,1  ,1  ,0  ,1  ,0  ,1  ,1  ,1  ,1  ,1  ,1  ,1  ,1  ,1  ,1  ,1  ,1  ,
12 ,12 ,12 ,12 ,12 ,12 ,12 ,12 ,12 ,12 ,12 ,12 ,1  ,1  ,1  ,1  ,0  ,1  ,1  ,1  ,1  ,1  ,1  ,1  ,1  ,1  ,1  ,1  ,1  ,1  ,
12 ,12 ,12 ,12 ,12 ,12 ,12 ,12 ,12 ,12 ,12 ,12 ,1  ,1  ,1  ,0  ,1  ,0  ,1  ,1  ,1  ,1  ,1  ,1  ,1  ,1  ,1  ,1  ,1  ,1  ,
12 ,12 ,12 ,12 ,12 ,12 ,12 ,12 ,12 ,12 ,12 ,12 ,1  ,1  ,1  ,1  ,1  ,1  ,1  ,1  ,1  ,1  ,1  ,1  ,1  ,1  ,1  ,1  ,1  ,1  ,
12 ,12 ,12 ,12 ,12 ,12 ,12 ,12 ,12 ,12 ,12 ,12 ,1  ,1  ,1  ,1  ,1  ,1  ,1  ,1  ,1  ,1  ,1  ,1  ,1  ,1  ,1  ,1  ,1  ,1  ,
12 ,12 ,12 ,12 ,12 ,12 ,12 ,12 ,12 ,12 ,12 ,12 ,1  ,1  ,1  ,1  ,1  ,1  ,1  ,1  ,1  ,1  ,1  ,1  ,1  ,1  ,1  ,1  ,1  ,1  ,
1  ,1  ,1  ,1  ,1  ,1  ,1  ,1  ,1  ,1  ,1  ,1  ,1  ,1  ,1  ,1  ,1  ,1  ,1  ,1  ,1  ,1  ,1  ,1  ,1  ,1  ,1  ,1  ,1  ,1  ,
1  ,1  ,1  ,1  ,1  ,1  ,1  ,1  ,1  ,1  ,1  ,1  ,1  ,1  ,1  ,1  ,1  ,1  ,1  ,1  ,1  ,1  ,1  ,1  ,1  ,1  ,1  ,1  ,1  ,1  ,
1  ,1  ,1  ,1  ,1  ,1  ,1  ,1  ,1  ,1  ,1  ,1  ,1  ,1  ,1  ,1  ,1  ,1  ,1  ,1  ,1  ,1  ,1  ,1  ,1  ,1  ,1  ,1  ,1  ,1  ,
1  ,1  ,1  ,1  ,1  ,1  ,1  ,1  ,1  ,1  ,1  ,1  ,1  ,1  ,1  ,1  ,1  ,1  ,1  ,1  ,1  ,1  ,1  ,1  ,1  ,1  ,1  ,1  ,1  ,1  ,
1  ,1  ,1  ,1  ,1  ,1  ,1  ,1  ,1  ,1  ,1  ,1  ,1  ,1  ,1  ,1  ,1  ,1  ,1  ,1  ,1  ,1  ,1  ,1  ,1  ,1  ,1  ,1  ,1  ,1  ,
1  ,1  ,1  ,1  ,1  ,1  ,1  ,1  ,1  ,1  ,1  ,1  ,1  ,1  ,1  ,1  ,1  ,1  ,1  ,1  ,1  ,1  ,1  ,1  ,1  ,1  ,1  ,1  ,1  ,1  ,
1  ,1  ,1  ,1  ,1  ,1  ,1  ,1  ,1  ,1  ,1  ,1  ,1  ,1  ,1  ,1  ,1  ,1  ,1  ,1  ,1  ,1  ,1  ,1  ,1  ,1  ,1  ,1  ,1  ,1  ,
1  ,1  ,1  ,1  ,1  ,1  ,1  ,1  ,1  ,1  ,1  ,1  ,1  ,1  ,1  ,1  ,1  ,1  ,1  ,1  ,1  ,1  ,1  ,1  ,1  ,1  ,1  ,1  ,1  ,1  *

0 - MUD
1 - GRASS
2 - TREE
